###                 #########
#   ###################   # #
# ####                # # # #
# ################### # # # #
#                     # # # #
##################### # # # #
#   ##********        # # # #
# # ##*### ##*######### # # #
# #****#   ##B#         # # #
# #*## ################ # # #
###*##             #### # # #
###*############## ## # # # #
###****         ##    # # # #
######*######## ####### # # #
######*####             #   #
A******######################
